            ############
            #*.........#
            #    TTTTT.#
            #  P #   T.#
            ######  ##.#
                    #..#
                    #.##
                 TTTT.#
                 #   .#
                 #S.*.#
                 #.####
                ##.#
      ###########..#
    ###....#....#.#####
    #  .  .#..#.#.....#
    #*..S#....#.*..##*#
    #.############.  .#
    #.#          #.  .#
    #*#          T...S#
    #E#          T#####
    ###



