         ###
         #E#
         #.#
         #.#
         #.#
      ####*#
      #S...#
      #. ###
      #.  #
      #...#
      ###.#
        #*#
        #.#
      ###.###
      #.....#
      #. .#.#
      #. .#.#
      #*.S#.#
   ########.#
   #....# #.#
   #.  .###.#
   #.  .....#
####.############
#.........#.S...#
#.  .####....   #
#.  .#  ###### *#
#....#   #     .#
######   #     .#
         #  P  .#
         ########
