
                  ###
#######           #E#
#....S########    #.#
#.     ......# ####.#
#.     #####*###.*..####
### P  #  ##...#.......#
  ######  #....#.  #  .T
          #...##......ST
          #...##*...####
          #...#####.##
          ###.#####..#
           #.*##.....#
           #S.....####
           T.. .###
           T.. .#
           T...*#
           ######



